2021202020
2000202020
2020202020
2000200020
2020202020
2020002020
2020202023
2020202020
2000202000
2020202220